1111111111111111
1000000000000001
1000000000000001
1000000011111001
1000000100000101
1000000100000101
1000000100000101
1000000000000001
1111111111111111
