111111111111111111
100000000000000001
100P00000000000001
100000001111100001
100000010000010001
100C000000C0010001
100000010000010001
1000000E0000010001
111111111111111111
