111111111111111111
100000000000C00001
100P00000000000001
100000001111110001
1000000010C0000001
100C00001011110001
100000001000E10001
1000000011111100C1
111111111111111111
